1 1 1 1 1 1 1 1 1 1 1 1 1 1 1 1 1 1 1 1 1 1
1 4 0 4 0 4 0 4 0 4 2 6 0 4 0 4 0 4 0 4 0 1
1 0 4 0 4 0 4 0 4 0 5 3 4 0 4 0 4 0 4 0 4 1
1 4 0 4 0 4 0 4 0 4 2 6 0 4 0 4 0 4 0 4 0 1
1 0 4 0 4 0 4 0 4 0 5 3 4 0 4 0 4 0 4 0 4 1
1 4 0 4 0 4 0 4 0 4 2 6 0 4 0 4 0 4 0 4 0 1
1 0 4 0 4 0 4 0 4 0 5 3 4 0 4 0 4 0 4 0 4 1
1 4 0 4 0 4 0 4 0 4 2 6 0 4 0 4 0 4 0 4 0 1
1 0 4 0 4 0 4 0 4 0 5 3 4 0 4 0 4 0 4 0 4 1
1 4 0 4 0 4 0 4 0 4 2 6 0 4 0 4 0 4 0 4 0 1
1 0 4 0 4 0 4 0 4 0 5 3 4 0 4 0 4 0 4 0 4 1
1 4 0 4 0 4 0 4 0 4 2 6 0 4 0 4 0 4 0 4 0 1
1 0 4 0 4 0 4 0 4 0 5 3 4 0 4 0 4 0 4 0 4 1
1 4 0 4 0 4 0 4 0 4 2 6 0 4 0 4 0 4 0 4 0 1
1 0 4 0 4 0 4 0 4 0 5 3 4 0 4 0 4 0 4 0 4 1
1 4 0 4 0 4 0 4 0 4 2 6 0 4 0 4 0 4 0 4 0 1
1 0 4 0 4 0 4 0 4 0 5 3 4 0 4 0 4 0 4 0 4 1
1 1 1 1 1 1 1 1 1 1 1 1 1 1 1 1 1 1 1 1 1 1