10 10 10 10 10 10 10 10 10 10 10 10 10 10 10 10 10 10 10 10 10 10
10 8 8 8 8 8 8 8 8 8 8 8 8 8 8 8 8 8 8 8 8 10
10 9 9 9 9 9 9 9 9 9 9 9 9 9 9 9 9 9 9 9 9 10
10 7 7 7 7 7 7 7 7 7 7 7 7 7 7 7 7 7 7 7 7 10
10 8 8 8 8 8 8 8 8 8 8 8 8 8 8 8 8 8 8 8 8 10
10 9 9 9 9 9 9 9 9 9 9 9 9 9 9 9 9 9 9 9 9 10
10 7 7 7 7 7 7 7 7 7 7 7 7 7 7 7 7 7 7 7 7 10
10 8 8 8 8 8 8 8 8 8 8 8 8 8 8 8 8 8 8 8 8 10
10 9 9 9 9 9 9 9 9 9 9 9 9 9 9 9 9 9 9 9 9 10
10 7 7 7 7 7 7 7 7 7 7 7 7 7 7 7 7 7 7 7 7 10
10 8 8 8 8 8 8 8 8 8 8 8 8 8 8 8 8 8 8 8 8 10
10 9 9 9 9 9 9 9 9 9 9 9 9 9 9 9 9 9 9 9 9 10
10 7 7 7 7 7 7 7 7 7 7 7 7 7 7 7 7 7 7 7 7 10
10 8 8 8 8 8 8 8 8 8 8 8 8 8 8 8 8 8 8 8 8 10
10 9 9 9 9 9 9 9 9 9 9 9 9 9 9 9 9 9 9 9 9 10
10 7 7 7 7 7 7 7 7 7 7 7 7 7 7 7 7 7 7 7 7 10
10 8 8 8 8 8 8 8 8 8 8 8 8 8 8 8 8 8 8 8 8 10
10 10 10 10 10 10 10 10 10 10 10 10 10 10 10 10 10 10 10 10 10 10